000000000139.jpg
000000000285.jpg
000000000632.jpg
000000000724.jpg
000000000776.jpg
000000000785.jpg
000000000802.jpg
000000000872.jpg
000000000885.jpg
000000001000.jpg
000000001268.jpg
000000001296.jpg
000000001353.jpg
000000001425.jpg
000000001490.jpg
000000001503.jpg
000000001532.jpg
000000001584.jpg
000000001675.jpg
000000001761.jpg
000000001818.jpg
000000001993.jpg
000000002006.jpg
000000002149.jpg
000000002153.jpg
000000579070.jpg
000000579091.jpg
000000579158.jpg
000000579307.jpg
000000579321.jpg
000000579635.jpg
000000579655.jpg
000000579818.jpg
000000579893.jpg
000000579900.jpg
000000579902.jpg
000000579970.jpg
000000580197.jpg
000000580294.jpg
000000580410.jpg
000000580418.jpg
000000580757.jpg
000000581062.jpg
000000581100.jpg
000000581206.jpg
000000581317.jpg
000000581357.jpg
000000581482.jpg
000000581615.jpg
000000581781.jpg
