000000000139.jpg
000000000285.jpg
000000000632.jpg
000000000724.jpg
000000000776.jpg
000000000785.jpg
000000000802.jpg
000000000872.jpg
000000000885.jpg
000000001000.jpg
000000580418.jpg
000000580757.jpg
000000581062.jpg
000000581100.jpg
000000581206.jpg
000000581317.jpg
000000581357.jpg
000000581482.jpg
000000581615.jpg
000000581781.jpg
