000000000139.jpg
000000000285.jpg
000000000632.jpg
000000000724.jpg
000000000776.jpg
000000000785.jpg
000000000802.jpg
000000000872.jpg
000000000885.jpg
000000001000.jpg
